..........
..........
....@.....
..........
...######..
..........
###.......
...#......
......#...
#######.#######