..........
..........
..........
..........
...######..
..........
###...@...
...#......
......#...
###############