##############...
#.............#
#.............#
#.............#
#...######....#
#.............#
##...........#
#.....@.......#
#.............#
###############