..........
..........
..........
..........
..........
..........
##....@...
...#......
......#...
###############