#.........
#.............#
#.............#
#.....#.......#
#...######....#
#.............#
###..........#
#...##@##.....#
#.............#
###############